1111111111111111111
1E00000000N00000001
1PCCCCC0000000N0001
1CCCCCCCCCCCCCCCCC1
1111111111111111111
