1111111111111111111
1E00000000N00000001
1P000000000000N0001
1000000000000000001
1111111111111111111
