11111111
1E000001
1PCCCCC1
11111111
